..............................
..............................
..............................
..............................
..............................
..............................
..............................
..S.......................G...
%%%%%%%%%%%%%%%%%%%%%%%%%%%%%%
##############################
..............................
..............................
..............................
..............................
..............................