..............................
..............................
..............................
..............................
..............................
..............................
.##..###...%..................
.#.#..#..%..%.................
.#.#..#.....%.................
.#.#..#..%..%.................
.##..##....%..................
..............................
..S.....###%..............G...
%%%%%%%############...%%%%%%%%
##################.....#######