..............................
..............................
..............................
..............................
..............................
..............................
..............................
..............................
..............................
..............................
..............................
..............................
..S.....###%..............G...
%%%%%%%############...%%%%%%%%
##################.....#######