..............#######.........
...............####...........
...............###............
................##%%..........
.........%%.....####.....#....
........##%%%#..###..........G
......########...##.........##
.......######....##.........##
##......####.....#..........##
#.S..%%%###...............%%##
#%%%%%#####..........#%%%%%###
##########%%.........#########
###########%%#.......#########
##############.........#######
#############............#####