...............######.........
.................###..........
%%%%.............###..........
###...............##..%%%%%%%.
#.................#....######.
...........###..........####..
.........######..........#....
..........#####...............
..S..#....%###................
.%%%%##%%%%%##...............G
..############%%..##.....%%%%%
...############%%%##.....#####
.....###############......####
........###########........###
...........................###