...............######.........
.................###..........
%%%%.............###..........
###...............##..%%%%%%%.
#.................#....######.
...........###..........####..
.........######..........#....
..........#####...............
..S..#....%###................
.%%%%##%%%%%##%..............G
..############%%..##.......%%%
...############%%%##.......###
.....###############........##
........###########..........#
.............................#