...............######.........
.................###..........
%%%%.............###..........
###...............##..%%%%%%%.
#.................#....######.
...........###..........####..
.........######..........#....
.............................
..S..#/////%###...............
.%%%%##%%%%%##%/.............G
..############%%..#########%%%
...############%%%##.......##
.....###############........###
........###########..........#
.............................#