........................................
%%......................................
###############.........................
.........................%%//...........
....................########............
...................#########............
..................##########............
%.S..............###########............
#####/...###################.........G..
...................................#####
...................................#####
...................................#####
#####//////////////###########.....#####
#%.................................#####
########################################