[level0]
background = background.png
tileset = tileset.png
map = ..............................
      ..............................
      ..............................
      ..............................
      ..............................
      ..............................
      ..............................
      ..............................
      ..............................
      ..............................
      ..............................
      ..............................
      ..S.....###%..............G..
      %%%%%%%############...%%%%%%%%
      ##################.....#######
   
[level1]
background = background.png
tileset = tileset.png
map = ..............................
      ..............................
      ............................G.
      ..........................%%%%
      ..........................####
      ...........................###
      ...........................###
      ............................##
      %%..........................#.
      #%%.S..%%##...................
      ##%%%%%%%%###.................
      #####%%%%####.................
      ############..................
      ###....#####..................
      ##......###...................  
      
[level2]
background = background.png
tileset = tileset.png
map = ...............######.........
      .................###..........
      %%%%.............###..........
      ###...............##..%%%%%%%.
      #.................#....######.
      ...........###..........####..
      .........######..........#....
      ..........#####...............
      ..S..#....%###................
      .%%%%##%%%%%##%..............G
      ..############%%..##.......%%%
      ...############%%%##.......###
      .....###############........##
      ........###########..........#
      .............................#

[level3]
background = background.png
tileset = tileset.png
map = ........................######
      ..........................####
      %%.G.......................##%
      #%%%%%##...................#%%
      #######.....................%#
      #####........................#
      ####......................#...
      ##........................#...
      #%.S..........%##...%%%#.##..
      %%%%%%%##...#%%%##..####.##...
      %%%%####....######...###.#....
      %%####.......####....###.#....
      %%%###........###.....##......
      %##............#......#.......
      %#............................
      
[level4]
background = background.png
tileset = tileset.png
map = ..............#######.........
      ...............####...........
      ...............###............
      ................##%%..........
      .........%%.....####..........
      ........##%%%#..###..........G
      ......########...##.........##
      .......######....##.........##
      ##......####.....#..........##
      #.S..%%%###...............%%##
      #%%%%%#####..........#%%%%%###
      ##########%%.........#########
      ###########%%#.......#########
      ##############.........#######
      #############............#####
      
[level5]
background = background.png
tileset = tileset.png
map = ##%%#####%%%%##########.......
      ###%%#....%#######%%##......G%
      ##..%.....###..#%%%##.....##%%
      #.......####....%..........###
      #........##..................#
      ##%...........#####...........
      %%%##........###%#####........
      #%%%####......#%%###..........
      #..%###........%...........%%.
      ...................%%...#####.
      %..S.............#%%##...####.
      %%%%%.....%%%%...#####....##..
      %###......####....###.........
      ##.........##.......#.........
      #.............................

[.]
name = air

[#]
name = stone
tile = 0, 0

[%]
name = grass
tile = 1, 0

[S]
name = spawn

[G]
name = goal
tile = 0, 1